Nancy	 Washington
Brian	 Peterson
Carlos	 Ross
Jonathan	 Green
Thomas	 Murphy
Edward	 Turner
Kevin	 Hill
Jesse	 Cook
Ryan	 Davis
Steven	 Johnson
Harold	 Gonzales
Kenneth	 Jackson
Willie	 Parker
Phyllis	 Howard
Anna	 Moore
Steven	 Williams
Jennifer	 Evans
Benjamin	 Price
Daniel	 James
Karen	 Walker
Ryan	 Butler
Jennifer	 Peterson
Anne	 Diaz
Patrick	 Adams
Phyllis	 Moore
Nicholas	 Alexander
Annie	 Sanders
Irene	 Washington
Gregory	 Jenkins
Carol	 Griffin
Steven	 Rodriguez
Bruce	 Edwards
Louis	 Bennett
Wanda	 Kelly
Maria	 Griffin
Phyllis	 Cooper
Aaron	 Roberts
Bonnie	 Campbell
Jennifer	 Diaz
Scott	 Williams
Margaret	 Cox
Juan	 Rodriguez
Ruby	 Campbell
Debra	 Smith
Samuel	 Mitchell
Mark	 Roberts
Diane	 Martinez
Sharon	 Stewart
Gary	 Wilson
Theresa	 Diaz
Domingo	 Todd
Caleb	 Wright
Jeremiah	 Vasquez
Kerry	 Christensen
Clarence	 Pierce
Bessie	 Snyder
Marianne	 Riley
Daisy	 Barnett
Roy	 Mckenzie
Lena	 Conner
James	 Bailey
Guadalupe	 Morris
Holly	 Conner
David	 Steele
George	 Lambert
Mark	 Mack
Pat	 Farmer
Ida	 Cain
Marvin	 Griffith
Dora	 Bennett
Cary	 Bush
Luz	 Barrett
Sophie	 Mendoza
Mary	 White
Gustavo	 Riley
Brandon	 Blake
Lydia	 Crawford
Enrique	 Jordan
Milton	 Butler
Sylvia	 Hines
Claude	 Hoffman
Randal	 Hamilton
Phillip	 Pearson
Rex	 Padilla
Travis	 Gibson
Edna	 Mullins
Juana	 Day
Darla	 Russell
April	 Cole
Christian	 Ramsey
Janie	 Barker
Tonya	 Mendoza
Theodore	 Jacobs
Arthur	 Craig
Brad	 Davis
Willard	 Torres
Julio	 Brock
Bobbie	 Pierce
Forrest	 Thornton
Beulah	 Zimmerman
Mamie	 Alexander
Jerry	 Wood
Kim	 Perry
Tracy	 Fernandez
Robert	 Hines
Carl	 Conner
Tyler	 Webb
Winifred	 King
Elbert	 Pena
Johnnie	 Cox
Colleen	 Robbins
Suzanne	 Mitchell
Otis	 Summers
Martin	 Jennings
Lamar	 Hudson
Robin	 Ryan
Allison	 Lowe
Lorena	 Aguilar
Renee	 Ford
Leonard	 Wong
Sam	 West
Cathy	 Houston
Ignacio	 Moreno
Maureen	 Curry
Armando	 Bailey
Henry	 Morgan
Stuart	 Walton
Tom	 Harvey
Edgar	 Robinson
Marco	 Silva
Alan	 Johnston
Yvonne	 Jensen
Kristy	 Floyd
Helen	 Peterson
Randall	 Erickson
Craig	 Fisher
Andre	 Cannon
Nick	 Poole
Agnes	 Turner
Bessie	 Francis
Josh	 Lindsey
Jeanette	 Chandler
Arlene	 Lambert
Charlene	 Barnett
Cora	 Howell
Pat	 Yates
Orville	 Austin
Douglas	 Ferguson
Gregory	 Carpenter
Sheryl	 Myers
Shawn	 Ray
Ted	 Franklin
Sonia	 Carr
Madeline	 Pratt
Maggie	 Bowen
Clayton	 Williams
Jeannie	 Hughes
Ruben	 Rodgers
Luther	 Baker
Jon	 Gross
Drew	 Snyder
Bobby	 Greer
Dorothy	 Johnson
Levi	 Wells
Mae	 Weaver
Marvin	 Ball
Lyle	 Hayes
Antonia	 Pittman
Willie	 Norman
Rosemarie	 Roberts
Darlene	 Larson
Constance	 Rodriguez
Don	 Mcguire
Margarita	 Gilbert
Harold	 Manning
Tamara	 Guzman
Rosemary	 Chapman
Ethel	 Brady
Ebony	 Moore
Nelson	 Frazier